1111111111111111111111111110111
1000000000100000100000000010001
1011111110111010101110111110101
1000001000000010101000101000101
1011101111111110101111101011101
1000100010000010001000001010001
1110111010111111101011111011101
1010100010000010001000101000101
1010101110111010111110101010101
1000100010100010001000100010101
1011111011101111101011111010101
1000100010001000001000001010101
1110101110111011111111101110101
1010100010001000100000101000101
1010111011101110101111101011101
1010001010000010001000100010101
1010111010111010111010111110101
1000100010001010100010100000101
1011101110101110101110101110101
1000100010100010101010000010101
1111111011111010101011111110101
1000000010001000100000100000101
1011111110101110111110101110101
1000001000100010100000101000101
1111101011111011101111101111101
1000001000001000101000100000101
1011111111101110101110111110101
1010000000100010100010000010101
1010111110111010111011111010101
1000000010000010000000000010001
1111111111111111111111111111101
