0000000000000000000000000001000
0111111111011111011111111101110
0100000001000101010001000001010
0111110111111101010111010111010
0100010000000001010000010100010
0111011101111101110111110101110
0001000101000000010100000100010
0101011101111101110111010111010
0101010001000101000001010101010
0111011101011101110111011101010
0100000100010000010100000101010
0111011101110111110111110101010
0001010001000100000000010001010
0101011101110111011111010111010
0101000100010001010000010100010
0101110101111101110111011101010
0101000101000101000101000001010
0111011101110101011101011111010
0100010001010001010001010001010
0111011101011101010101111101010
0000000100000101010100000001010
0111111101110111011111011111010
0100000001010001000001010001010
0111110111011101011111010111010
0000010100000100010000010000010
0111110111110111010111011111010
0100000000010001010001000001010
0101111111011101011101111101010
0101000001000101000100000101010
0111111101111101111111111101110
0000000000000000000000000000010
